1111111
1000PC1
1C0C001
10E0C11
1111111
