1111111111
100000P001
100C010001
1000011111
1000010E01
1111111111
