1111111111
1000000001
100C0PE000
1000000001
1111111111
