1111111111
1000000001
100COPE001
1000000001
1111111111
