1111111111
1000000001
100CEPE001
1000000001
1111111111
