1111011111
1000000001
100C0PE001
1000000001
1111111111
