1111111111
000000001
100C0PE001
1000000001
1118111111
