1111111111
1000000001
100C01E001
1000011111
10P0010C01
1111111111
