1111111111
1000000001
000C0PE001
1000000001
1111111111
