1111111
1000P11
1C0C101
1C0C001
1C0CE11
1111111
