111111111111111111111111
1000P00000000CC000000011
1C0C101000000000000C00C1
1C0C001000000000C0CC1111
1C0CE11110000C0000000011
111111111111111111111111
