111111111111111111111111
1000P00000000CC000000001
1001101001110000100C00C1
10C000E000C111C000100001
100C011110000C0000000001
111111111111111111111111
