111111111111111111111111
1000P00000000CC000000011
1001101001110000100C00C1
110000100000C010C0CC1111
100CE11110000C0000000011
111111111111111111111111
