1111111111111111111111111111111111
110000000000000C00000C000000L00001
101L010100100000101001000R00010101
1010010010101010001E01000000010101
1P0000000C00C0000000000000R00000C1
101L010100100L00101001000L00010101
101R0101001000L0101001000R00010101
10111100R0000R000R0000C000C0C01111
1C000001110010R00000011R1100001L11
111011100R0011110000L1R0111L000C11
1111111111CCL1001CLC1R11L10011C111
1111111111111111111111111111111111
