11111111111111
1000E0CCCP0C01
1CCCR000C00001
11111111111111
