11111111111111
1000E0CCCP0C01
1CCCR0L0000C01
11111111111111
