1111111111
1000000001
100C01E001
10000XX0X1
10P0000C01
1111111111
