1111111111
100000P001
100C010001
100001X111
1000010E01
1111111111
